1111111111111
1P000000E00C1
1000001000001
1111111111111
