1111111111
1P00000001
1000C00011
10000000E1
1111111111