1111111111111111
1C000000000E0001
1C00000000000001
1000P00000000001
1111111111111111