111111111111111111
1E0000000000000001
100001001010010101
100001001010010101
1P0000000C000000C1
111111111111111111
