11111111111111111111111111111111
1000E0000000000X00000110000001X1
1000C10001C00X00011000C000000001
100000000000000P0000000000000001
11111111111111111111111111111111